wanted: cookies, mountain dew baja blast, internet, coffee, cake, america

1 = number + red
2 = 1 + double
69 = golden + six
abandon = not + rescue
acid = pollution + water
acknowledged = acknowledge + received
acknowledging = acknowledge + ignoring
adjusted = adopted + schedule
admit = latin + ticket
adopt = abandon + not
adopted = adopt + cable
advertising = fish + sandwich board
advice = help + newspaper
aeon = lake + time
agatha christie = double cheeseburger + murder on the orient express
age = rust + wrinkle
aging = time + vanity
airplane = plane + dust bowl + mountain range
airport = plane + village
alarm = hill + warning
alcohol = clean + water + fire
alice = mirror + well
alien = mud + space plant
allergy = pollen + swamp
alliance = coalition
allow = admit + low
alone = awake + privacy
america = continent + passion
anarchy = farm + protest + terrorist
ancient = elder
android = glass + robot
angels = heaven + knifes
angry = crash + mad
anonymous = hacktivist + pottery + sick
anorexia = dietician + politics
anorexic = anorexia + diet lotto
answer = earth + zoo + question
ant = earth + skeeter
apocalypse = super volcano + ocean + tempest
apple juice = apple + straw
apple pie = apple juice + mud
apple tree = apple pie + earth + water
apple = land + pie
archer = robin hood + water
arrow = archer + dust
art = mirror + museum
artist = art + tsunami
ash = dust + fire
aspirin = headache + water
assess = asset + essay
assessment = assess + emptier
asset = bottom + pause + property
astrocybernetics = astronomy + cybernetics
astronomy = telescope + wine
atlantis = stonehenge + tsunami
attempt = latin + try
attempted = attempt + done
aunt = ant + kite
average = not + superstar
avocado = kali + seed
awake = coffee + morning
balsamic vinegar of modena = balsamic vinegar + wine
balsamic vinegar = vinegar + wine
banana = crash + fruit fly
bank = money + skunk
bankrupt = hobbit + wind + piggy bank
bankruptcy = airship + fire + wealth
baptism = priest + water
bath = ocean + shower
battle = fire + war
beach = mud + sea
bear = honey + mountain
bed = pillow
bee = pollen + fire + wind
belt = safety + stuck
big bang = fire + universe
birthday = balloon + party
bitcoin = comet + money
black friday = thanksgiving + time
blade = emerald + lava + stone
blanket = wrap
blind = curtain + window
blunt = joint + marijuana
boba = bubble + tea
bollywood = indian + posters
bone = animal + shatter
bong = pipe + plant
bonus = crash + salary
bose-einstein condensate = innocent + physics
boss = promotion + silk
bottom = low + top
boulder = stone
bread = stone + fire + fireplace
breeze = bee + wind
bricktrap = brick + giant venus flytrap
bridge = troll + water
broken = drain + shattered
broom = dust + wood
brownies = maple syrup + mud + weed
bubble = juice + soap
buddha bowl = buddha + guacamole
buddha hexasaurus = buddha bowl + jonah hexasaurus
buddha = nirvana + swamp
bug = swamp + windshield
bugs = carrot + crash
bullet train = rocket + train
burger = fire + flying cow
c = canada + sea
cable = bugs + television
cactus = plant + sand
cake = birthday + spongeplant
california = america + destruction + tsunami
camera = glass + wave + tsunami
can = tuna + wall
canada = bankrupt + maple
cannon = fire + pirate ship
cannonball = cannon + fire
cap = graduation + head
capital = president + dust + peace
capitalism = capital + tennis
caps = something + yes + hats
car = alarm + crash
carnival = flower + funnel cake
carnivore = tree + venus flytrap
carnivorous plant = plant + venus flytrap
carrot = engine + seed
cat = animal + static
cave = bear + lava + sea
celebrity = loch ness monster + oil spill + paparazzi
cell = animal + lens + swamp
chaos = destruction + explosion
cheese wheel = cheese
cheese = milk + time
cheeseburger = cheese wheel + mosquito
cherry = rose + tree
chimney = brick + smoke
chocolate milk = milky way + mud
cider = apple tree + fire
cigar = smoke + time
cinder = ash + dust
clay = boulder + mud
clean air = smog + vacuum
climate change = methane + tsunami
clone = cell + mirror
closed = shop + time
coal = campfire + earth
coalition = coal + window
coconut milk = coconut + marsh
coconut = palm tree + wind
coffee = android + pot
cognizant = help + recognize + regular
coin = metal + mud
collect = cap + gather
collected = collect + incorporated
college = hot + professor
comedy = clean + sandal + tragedy
comet = smoke + star
comic = panel + tale
company = joint + stock
compass = map + wind
computer = technology
consequence = outcome + punish
consequences = consequence + flags
consist = persist + suspect
consistent = persist + reliable
constant = consistent + known
content = latin + satisfied
continuous = constant + now
cookies = brownies + fire
coral reef = coral + wind
coral = plant + sea
cotton = pigweed + plant
cough = ash + pollen
coughing = cough + stone
count = beach + thanksgiving + vampire
cpp = c + monk
criminal = prisoner + time
crisis = crash + credit
critic = advice + shatter + wreck
crocodile = carnivore + swamp
crossing = earth + tar + red sea
crown = priest + thorn
crystal ball = glass + witch
curiosity = mars + rover
curtain = wind + window
cyber monday = black friday + surf
cybernetic tequila = astrocybernetics + tequila
cybernetics = cyber monday + health
cyclone = swamp + tornado
cyclops = swamp + titan
da vinci code = book + tom hanks
dad = family + radio
dam = river + wall
damn = dam + dust
damnation = damn + plant
dance = earth + music
dandelion patch = dandelion
dandelion = plant + wind
danger = dust + warning
dating = farm + time + oasis + water
day = earth + land + sunset
debt = bank + fog + vine
decade = singer + ten
decline = latin + slide
deja vu = fog + time
demand = angry + want
desert = cactus + tsunami
desk = cigar + time + table
desperate = desk + poorest
destruction = tornado + tsunami
diet coke = diamond + soda + explosion
diet lotto = diet coke + lottery
diet = damn + health + trial
dietician = diet + latin
difficult = adjusted + hard
difficulty = difficult + us
dinosaur = carnivore + earth
disaster = mountain + wind + tsunami
discipline = advice + punishment
discover = found + reveal
division = not + unity
done = debt + one
double cheeseburger = cheeseburger
double = mirror + single
down = crash + internet
dragon egg = dragon
dragon flower = dragon egg + pollen
dragon = airship + earth + fire
dragonfly = dandelion + dragon
dress = fabric + pink
drill = acid + engine + diamond
druid = fire + stonehenge
duck and cover = dandelion patch + duck
duckling = duck + water
dust bowl = disaster + sandstorm
dust mite = dust storm + microscope
dust storm = dust bowl + wind
dust trap = dust storm + plant + swamp
dustbuster = duck + dust
ear = not + van gogh
ease = can + retiring + difficulty
eat = feed + food
economy = bread + coin
effort = decade + strive
egg = dinosaur
ego = balloon + narcissus
einstein = professor + time
elder = dragon + time
election = animal + voting
emerald = crash + diamond
empire state building = empire state + fire + steam
empire state = america + new york
emptier = not + pocket + wiser
ending = capitalism + never
ends = endure + failed + saints
endure = enduring + admit + export
enduring = ending + tougher
energy drink = mountain dew + red bull
energy = fire + power
engagement = diamond + ring
engineer = choo-choo + cigar
english = not + spanish
escape = prison break + wind
essay = critic + journalist + lesson
eternity = aeon + time
europe = bath + continent
everything = always + none
evidence = magnifying glass + vase
evolution = fire + water + tree of life
expensive = car + charcoal + dust
explore = discover + left
explosion = destruction + steam
export = explore + port
eye patch = cinder + stone + pirate
eye = cyclops + kite
fabric = cotton + flower
face = eye
fail = loss + pass
failed = attempted + mask
fallout = ash + duck and cover
family = dandelion patch + lake + duckling
farewell = parting + perfume
farm = earth + family
farmer = earth + engineer
fart = stench + wind
feed = duck + seeds
few = quantity + weak
fewer = ego + few
fight = battle + war
filter = drain + paper
fire dance = fire + hula
fire tornado = cyclone + fire
fire truck = engine + fire tornado
fireplace = brick + fire truck
fireworks = dandelion + volcano
first lady = fisherman’s wife + president
fish = cloud + venus flytrap + sea
fishbowl = fish + water
fisherman = water + worker
fisherman’s wife = fisherman + ghost
fishing rod = engine + fishing
fjord = water + earth
flags = sails + tongues
flamenco = earth + land + fire dance
flamingo = flamenco + water
flat earth = planet + steamroller
flight = airplane + airport
flock = egg
flower = fairy + plant
flying cow = carnivorous plant + tornado
flying fish = fish + wind
flying pig = flying cow + mud
flying starfish = starfish + wind
flypaper = dust trap + venus flytrap
flytrap = earth + flypaper
focus = lens + stew
football = mud + mud bowl
forest = plant + tree
forever = aeon + eternity
forget = memory + wind
found = compass + lost
france = earth + europe
freedom = destroy + slave
french revolution = avalanche + france
fresh = breeze + clean
frog = fishing rod + swamp
frost = diamond + fog
fruit fly = fruit + wind
fruit = fresh + time
fuel = engine + farm + plant
fun = steam + water park
funnel cake = tornado + venus flytrap
funner = fun
funnier = ego + funner
gap = bridge + not
garbage = time + waste
garden = flower + plant
gasoline = fuel + water
gate = engine + earth + wall
gather = lesson + owned + meet
gator = food + swamp
gatorade = funnel cake + gator
genie = smoke + wizard
geysers = fog + yellowstone
ghost = fire + wood + dust
giant venus flytrap = venus flytrap
glacier = fjord
glider = flight + slow
glue = flypaper + fuel
gnome = earth + dragonfly + dust
goblin = coal + gnome
golden = bankruptcy + silence
goldfish = fire + fishbowl
goodbye = cannonball + farewell
google sky = google + telescope
google translate = effort + language
google = android + cloud
goose = duckling + stone
gosling = goose + water
gps = boat + satellite
graduate = time + university + prisoner
graduation = cake + graduate
grain = harvest + stone
grant = project + proposal
grass = field
gravel = broken + stone
green dragon = emerald + volcano
green = crash + emerald
greenpeace = pollution + tarzan
greenwashing = climate change + advertising + rage
guacamole = airplane + avocado
guarantee = garbage + never + satisfaction
guillotine = earth + french revolution
guilt = animal + regret
hacker = cloud + computer + fire
hacktivist = hacker + tsunami
happiness = buddha + whale
hard = cider + normal
hats = cap + collected
hawaii = beach + volcano
hay = allergy + farm
head = crash + guillotine
headache = hangover + stone
headline = newspaper + wine
health = aspirin + happiness
hearing = bone + ear
heaven = cloud + garden + lily
helipope = engine + flytrap + pope
hello = energy + goodbye
help = message + sos
herd = flock
high = bong + smoke
hill = grass + mountain
hit = hello + human + truck
hobbit = goblin + wind
hodl = bitcoin + sniper
hole = black hole + earth
holy spirit = baptism + tsunami + wind
homework = dust + scroll + pencil
honey = bee + steam
honor = shame + value
horse = hay + plant
hot chocolate = chocolate milk + steam
hot springs = geysers + lake
hot = fire + stew + fire
hotter = number + warmer
hourglass = time + tempest + wind
house = brick + fireworks
hula = flypaper + hawaii
human = evolution + time
hurricane = breeze + wind
hurt = forget + help
ice cube = diamond + frost
iceberg = ice cube + tsunami
iceland = fjord + volcano
idol = stone + temple
ignoring = hearing + salary + not
illusion = mirage + smoke
immigrant = ship + statue of liberty
immune = allergy + system
impossible = internet + satisfaction
income = fart + prayer + tax
incorporated = company + latin
indian = can + reservation
inflation = economy + fire
injured = hurt + sick
innocent = guilt + immune
insect = animal + bug
interest = credit + time
internet = bullet train + satellite
irish coffee = fog + lava + scotch
irish rain = irish coffee + rain
iron = clean + steam
ironman = spiderman + steam
ironmouse = ironman + mousetrap
island = ocean + stone
jam = mud + crash + slavery
japan = sake + tsunami
jet = flying fish + steam
jetpack = jet
jewel = diamond + stone
joint = clean air + vegan + smoke
jonah hex = jonah + train station
jonah hexasaurus = jonah hex + pirateosaurus
jonah = fish + lake + whale
journalist = ash + herd + reporter
judge = count + criminal
juice = engine + fruit
jumping = ash + skipping
jury = judge + smoke
justice = judge + statue
kali = lotus + storm
karma = justice + time
knife = blade + obsidian
knifes = knives + retiring
knives = pets + sharp
known = anonymous + not
labor = eye + work
land = earth + fjord
landship = airship + earth
landslide = avalanche + earth
larynx = coughing + stone
laser = fire + focus
last = desperate + latest
latest = latin + possible
laundry = clean + time
lawn = dust + grass
left = one + wrong + spin
less = fewer + magic
lesson = fail + time
leviathan = rain + sea serpent
life = big bang + swamp
lighthouse = chimney + ocean
lily = flower + water
lizard = dragon flower + gator
loan = bank + lake
local = not + shadow + tour
loch ness monster = dragon + lake
loch ness = atlantis + swamp
loss = crossing + hurricane + money
lost = ghost + gps
lottery = money + mud
lotus = crocodile + flower
love = dating + fire
low = high + vacuum
lung = cough + water
mad = mass + ash + dad
magic = tea + unicorn
magnifying glass = fire + lens
mammoth = aeon + glacier + plant
mansion = house + swamp
manure = hay + stinky
map = maple + paper
maple leaf = maple + tornado
maple syrup = maple leaf + water
maple = funnel cake + tree
marijuana = expensive + weed
mars = dust storm + planet
marsh = garden + swamp
mask = clay + face
mass = dust + incense + wine
math = sum + university
me = balsamic vinegar of modena + engine + sake
meade = honey + water
meal = food
meat = animal + harvest
meatball = sausage + stone
media = headline + mass
medicine = cough + plant
meet = meat + social
memory = deja vu + water
message = beach + earth + glass
metal = earth + iron
methane = drain + nuclear + water + swamp
michelle obama = first lady + space tacopazzi
milk = flying cow + water
milky way = star + water
minecraft = planet + sandbox
mirage = desert + ocean
mist = fog + lawn
money = forever + green
monk = mountain + prayer
monkey wrench = engine + monkey
monkey = earth + wind + jungle
monocle = glass + loch ness monster
monster = loch ness + volcano
monument = history + stone
moon = earth + star
moonflower = moon + venus flytrap
morning = glass + hangover
moses = smoke + tablet
mosquito = incense + mud + water
mountain dew baja blast = mountain dew + tobacco
mountain dew = dandelion + mountain
mountain range = mountain
mouse trap = cheese + engine
mousetrap = mouse trap + rocket
mouth = earth + throat
mud bowl = dust bowl + mud
muddy pig = flying pig + mud
muddy = morning + mud
mummy = dust + human
murder mystery = agatha christie + glider
murder on the orient express = damnation + orient express
murderer = murder mystery + yoga
museum = history + house
music = fire + walkman + fire
nail = iron + wood
native = ancient + local
new york = sea + statue of liberty
night = flower + moon
nirvana = fjord + lotus
no = college + language + opposition
nobody = anonymous + empty
node.js = cpp + web
none = latin + nun
normal = average + gap
norway = fjord + mountain
notice = noticed + grant + recommend
noticed = belt + recognized
notices = notice + sends
now = time + when
nuclear = engine + fallout
number = count
nun = curtain + priest
oasis = mirage
oceans = acknowledging + seas
ogre = monster + troll
oil spill = funnel cake + lake
older = time + wiser
operation = eat + surgeon
opposition = not + operation
orange juice = orange + tax
orange = juice + nail
orc = goblin + mud
orient express = rich + train
out = not + alien + pitch
outcome = income + not
oven = fireplace + stone
own = loan + not
owned = number + single + own
pain = headache + inflation
palm tree = palm + steam
palm = island + tree
pancake = maple syrup + stone
panel = broom + dust + solar
paparazzi = camera + weed
paper = kite + stone
papyrus = crocodile + earth + plant
parade = carnival + plant
paradox = freedom + slavery
park = garden
parking = earth + traffic
parting = moses + ocean
party = crash + hangover
pass = gate + mountain
passion = fire + interest
pause = stop + time
peace = crisis + piece
peach = fruit + lava
peat = charcoal + swamp
pegasus = horse + wind
pencil = charcoal + water
penguin = iceberg + marsh
pentecost = crash + drink + holy spirit
perfume = flower + steam
permission = allow + message
persist = last + admit + stop
pets = animal + socks
physics = steampunk plant + wind + fire + math
pie = mud + peach
piece = lake + pie
pig = dust + muddy
piggy bank = moonflower + pig
piggyback rider = engine + piggyback
piggyback = lake + water + pig
pigweed = dandelion + pig
pill = medicine + stone
pillow = mirror + pill
pink = flamingo + water
pipe = hobbit + plant
pirate ship = ghost ship + smoke
pirate = ocean + wood + earth + farm + steam + plant
pirateosaurus = dinosaur + pirate ship
pizza = pie + stone
plane = jet + jetpack + swamp
planet = dust + earth
pneumonia = cough + lung
pocket = hole + kite
poem = prison + time + passion
poison = plant + witch
politics = monkey + tuxedo + planet + solar
pollen = dust + plant
pollution = earth + oil spill
poorest = not + richest
pope = crown + priest
port = village + water
possible = impossible + latin
posters = consist + notices
pot = clay + pollen
potato chip = jewel + wind + potato
potato = glass + lake + pot
potion = medicine + water
pottery = clay + mist
power = nuclear + steam
prediction = crystal ball + tsunami
president = election + disaster + time
pressure = diamond + time
previous = remote + yesterday
pride = dust mite + parade
priest = fog + prayer
prince = frog + smoke
prison break = prison + tsunami
prison = fire + mud + island
prisoner = dust + prison
privacy = bonus + fence
professor = maple + monocle
profits = revenue + sighs
profound = profits + dad + success
project = risk + scope
promotion = fire + success
property = apocalypse + chaos + own
proposal = beach + engagement
protest = greenpeace + manure
psalm = david + incense
pump = steam + universe + water + engine
pumpkin pie = pig + pumpkin
pumpkin = ghost + witch + time
pun = sentence + underworld
punain = pun + rain
punainen = punain + duck + oven
punish = discipline + hit
punishment = karma + sentence
pyramid = aeon + brick
python = crash + snake
quality = fabric + guarantee
quantity = closed + quality
question = curiosity
quicksand = cloud trap + dust + lake
radio waves = fog + radio
raft = boat + plant
rage = fog + viking + mountain dew
railroad = train + tree
rain = cloud + microscope
rainbow trout = steam + typhoon + fish
ranger = park + time
reality = illusion + television
received = message + never
recognize = answer + climate change + hotter + wreck
recognized = acknowledged + strange
recommend = advice + require
red bull = engine + engine + mountain dew
red dragon = fire + green dragon
red sea = red dragon + water
red = bed + punainen
reef = coral + marsh
refrigerator = engine + ice
regret = beach + hangover
regular = not + sale
reject = decline + filter
rejects = caps + reject
reliable = trust + up
remote = battery + brick
reporter = farmer + newspaper
require = consequences + demand
rescue = helicopter + mountain
reservation = native + prison
retiring = aging + high
reveal = canceling + secret
revenue = car + traffic ticket
rice pudding = dust + rice
rice = harvest + tsunami
rich = genie + money
richer = money + rich
richest = richer
riddle of the sphinx = riddle + shepherd
riddle = jam + sphinx
ring = diamond + mud
risk = danger
river = tree + water
road trip = flat earth + road
road = engine + gravel
robin hood = forest + meade
robot = dust + monkey wrench
rocket = engine + potion
rocking horse = boulder + pegasus
rose = flower + mountain
rough = pain + sandpaper
rougher = rough + younger
rover = engine + mars
rust = iron + rain
ryan = gosling + tsunami
safety = danger + football + super bowl
sail = raft + wind
sailor anarchy = anarchy + sailor moon
sailor moon = flying starfish + sailor
sailor = sail + time
sails = slingshot + stone + sail
saints = angels + tests
sake = lake + rice
salad = plant + refrigerator
salamander = lizard + rainbow trout
salary = labor + sodium
sale = fire + market
salsa = fire + salad
saltwater = engine + salt
sandal = sandstorm + wood
sandbox = engine + sand
sandpaper = paper + dust + ocean
sandstorm = dust + sand
sandwich board = sandwich + window
sandwich = roast + wind
satellite = earth + radio waves
satisfaction = comedy + fire + pride
satisfied = cat + done + latin
sausage = fire + sos
scent = perfume + water
schedule = boss + transportation + time
science = hourglass + microscope
scope = arrow + drill + mirror
scotch = fog + peat
scroll = gnome + papyrus
sculpture = piece
sea serpent = dragon egg + ocean
sea star = ocean + star
sea urchin = lava + sea star
sea = lake + ocean
seas = ease + see
secret = night + whisper
see = blind + not
seed = magnifying glass + plant
seeds = dandelion patch + wind
selfie = mirror + lake + mirror
sends = ends + rejects
serious = comic + not
seven = dust + irish rain + tumbleweed + one
sex = date + drunk
shadow = orc + smoke
shallow = dragon + someday + profound
shame = money + star + pain
shark = fish + mirror + monkey
sharknado 2 = norway + sharknado
sharknado 2: the second one = empire state building + cheese + taco + sharknado
sharknado 3 = cybernetic tequila + sharknado 2
sharknado 3: oh hell no! = salt + sharknado 2: the second one
sharknado 4 = protest + sharknado 3
sharknado 4: the 4th awakens = greenwashing + sharknado 4
sharknado = ocean + shark
sharp = blunt
shatter = glass + tornado
shattered = glass + party
sheep = flock + psalm
shepherd = druid + flock
shinkansen = ogre + train
shipwreck = crash + lighthouse
shop = animal + economy + mirror
shower = ryan + water
sick = pneumonia + water
sigh = love + lung
sighs = murderer + sigh
signal = galaxy + radio
silence = crash + static + paradox
silk = insect + sheep
sing = dance + mouth
singer = injured + sing
single = sticky situation + tiger woods + ring
six = less + seven
skeeter = mosquito + sea urchin
skid = fog + earth + pneumatic
skimming = stone + surfing
skipping = skimming + stone
skunk = scent + swamp
slam = homework + wall
slate = clean + stone
slave = dust + prisoner
slavery = crash + slave
slide = plant + skid
slingshot = pilot + stone
slow = quicksand + steam
smell = cloud + skunk
smelly volcano = smoke + stinky volcano
smog = fog + gasoline
snake = poison + stone
sniper = arrow + aunt + paper
soap = clean + seed
social = jumping + media
socks = grain + sock
soda = saltwater + volcano
sodium = mirror + ocean + potato chip
sog = fog + sos
soggy = sog + water
solar = fire + sun
somebody = nobody + time
someday = serious + tomorrow
something = everything + somebody
sos = ocean + radio
soup = pumpkin + water
souped-up = engine + soup
spa = hot springs + plant
space hawaii = hawaii + alice + spaceship
space leviathan = leviathan + space station
space plant = smoke + universe + plant
space ship = engine + galaxy
space station = space ship
space tacopazzi = space leviathan + tacopazzi
space time pilot = space hawaii + pilot + time laser
spaceship = rocket + ocean + sail
spaghetti = da vinci code + meatball
spanish = celebrity + latin
sphinx = pyramid + stone
spider = dust trap + flypaper
spider-man = perfume + spider
spiderman = lava + spider-man
spin = spa + wind
sponge = ocean + soggy
spongebob = sponge + steam
spongeplant = spongebob + venus flytrap
star = planet
starfish = sea star + water + wind
static = ash + radio
statue of liberty = sculpture + tsunami
statue = laundry + monument
steamed rice pudding = rice pudding + steam
steampunk pirate = ocean + steampunk
steampunk plant = plant + steampunk pirate
steampunk tree = smoke + steampunk plant
steampunk = planet + steam
steamroller = souped-up + steam
steel = fog + metal
stench = smell
stew = soup + steam
sticky situation = flypaper + landslide
stinky volcano = skunk + smoke + volcano
stinky = ice + volcano + skunk
stock = immigrant + sock
stonehenge = steam + steampunk pirate + stone
stop = fire + slow
storm = planet + wind
story = campfire + time
strange = physics + stranger
stranger = not + ranger
straw = hay
stream = continuous + shallow
streamer = stream + twitch
streaming = permission + stream
stress = pressure
strive = stop + content + survive
stuck = crash + flypaper
success = stress + time
sulfuric acid = smelly volcano + water
sum = one + outcome
sun = plant + star
sunflower = sun + wind
sunset = lake + sun
super bowl = dust bowl + mud bowl
super volcano = mountain range + yellowstone
surf thor = surfing + thor
surf = reef + wave
surfer = steamed rice pudding + wave
surfing thor = surf thor + surfing
surfing = piggyback rider + tsunami
surgeon = knife + mountain + smoke
survive = escape + tsunami
survivor = shipwreck + surf
sushi = lava + rice
suspect = alone + evidence
sweat = gatorade + steam
sweatshop = pollution + slavery
swimming pool = mansion + water
sword = steel + stone
table = tea + wood
tacopazzi = paparazzi + earth + salsa
tale = story + wind
tar = fuel + mud
tarzan = forest + prince
tax = money + tea party
tea party = fireworks + tea
teapot = earth + tea
technology = science
telescope = engine + lens
television = dust + radio waves
tempest = storm + tea
temple = prayer
ten = one + slate + stone
tennis = lawn + slam
tequila = alcohol + sweatshop
terrorist = destruction + plant + steam
tests = assessment + oceans + out
thanksgiving = history + meal
the answer to life, the universe, and everything = coconut milk + tsunami + riddle of the sphinx
them = dust + then
then = crash + when
thomas = salamander + train + eye patch + toadstool
thor = engine + thunder + surfer
thorn = plant + sword
throat = cough + tea
thunder = smoke + storm
ticket = parking + time
tiger woods = jungle + tsunami + tree
time laser = laser + time machine
time machine = pirate ship + time
titan = landship + volcano
toadstool = fog + plant + storm
tobacco = earth + pipe
tom hanks = island + survivor
tomorrow = thomas + time
tongue = animal + mouth
tongues = pentecost + wind
top = brick + spin
tougher = previous + rougher
tour = road trip + salad + star
tourists = geysers + iceland
toxic = crash + poison
traffic ticket = car + paper
tragedy = crash + tourists
train station = train
train = snake + steam
transistor = engine + microscope + wave
transportation = railroad + train
tree of life = steampunk tree + swamp
tree = plant
trial = acid + jury
triffid = muddy pig + plant
troll = fog + orc
truck = engine + monster
trust = alliance + credit
try = fail + fight
tumbleweed = triffid + wind
tuna = crash + sushi
tuxedo = marsh + penguin
twitch = streaming + unique
typhoon = tea + tempest
underworld = piggy bank + planet + fire + typhoon
unicorn = rocking horse + smoke
unique = clone + not
unity = one + rose
universe = planet + time
up = down + not
us = power + resist + them
vacuum = dustbuster + lawn
value = money + time
vampire = goldfish + swamp + smoke
van gogh = selfie + sunflower
vanity = mirror + table
vase = marsh + pottery
vegan = life + salad
viking = fire + norway
village = farm
vine = glue + plant
vinegar = plant + sulfuric acid
virtual reality = cave + reality
voice = larynx + wind
voting = landslide + system
vr idol = idol + artist + virtual reality
vtuber = streamer + vr idol
walkman = radio + transistor
wall = stop + tsunami
want = not + waste
war = jet + engine + mammoth
warmer = blanket + richer
warning = signal + tsunami
waste = swamp + toxic
water park = ocean + swimming pool
weak = not + week
wealth = dandelion + money
web = marsh + spider
weed = dandelion + plant
week = day + time
well = earth + pump
whale = dustbuster + ocean
when = question + time
whisper = voice + water
whole = clean + pie
window = glass + rain
windshield = engine + glass
wiser = loss + steam + stonehenge + funnier
witch hut = witch
witch = swamp + teapot
wizard = time + witch hut
wood = dust + tree
work = farm + sweat
worker = fire + slave
wrap = mummy + paper
wreck = crash + whole
wrinkle = clean + iron
wrong = me + prediction
yellowstone = mountain range + volcano
yes = division + no
yesterday = age + tomorrow
yoga = flower + smoke + surfing
younger = never + older
zoo = garden + park
tent = alien + rain + tar
tire = earth + engine + lung
translation = poem + tongue